.d 0
.d11
.d22
.d33
.w16
.h16
1111111111111111
1              1
1              1
1    1         1
1            2 1
1  1   1111111 1
1              1
1    1    311111
1    1         1
1    1       1 1
1    1 3    1  1
1    1 1   3   1
1    1 1  1    1
1    1 1 1     1
1      1       1
1111111111111111
